# Authors

רבש	רב ברוך שלום הלוי אשלג	רב ברוך שלום	הרב ברוך שלום הלוי אשלג	הרב ברוך שלום
בעל הסולם	בעהס	רב יהודה אשלג	רב יהודה הלוי אשלג	רב יהודה ליב אשלג	רב יהודה ליב הלוי אשלג	רב אשלג	יהודה אשלג
רב לייטמן	רב דר מיכאל לייטמן	מיכאל לייטמן	לייטמן
ארי	רב יצחק לוריא	האלוקי רב יצחק	האלוקי רב יצחק לוריא	האריזל	הארי הקדוש
רמחל	משה חיים לוצאטו	לוצאטו
הראיה קוק	רב קוק	רב אברהם יצחק הכהן קוק
הבעל שם טוב	הבעשט

# Sources

זוהר לעם	זוהר	ספר הזוהר
ליל הכלה	תיקון ליל שבועות	לילה דכלא
תלמוד עשר הספירות	תעס
בראשית	פרשת בראשית	ספר בראשית	פרשת השבוע בראשית
שמות	ספר שמות	פרשת שמות	פרשת השבוע שמות
וארא	פרשת וארא	פרשת השבוע וארא
בא	פרשת בא	פרשת השבוע בא
בשלח	פרשת בשלח	פרשת השבוע בשלח
יתרו	פרשת יתרו	פרשת השבוע יתרו
משפטים	פרשת משפטים	פרשת השבוע משפטים
תרומה	פרשת תרומה	פרשת השבוע תרומה
תצוה	פרשת תצוה	פרשת השבוע תצוה
כי תשא	פרשת כי תשא	פרשת השבוע כי תשא
ויקהל	פרשת ויקהל	פרשת השבוע ויקהל
פקודי	פרשת פקודי	פרשת השבוע פקודי
ויקרא	ספר ויקרא	פרשת ויקרא	פרשת השבוע ויקרא
צו	פרשת צו	פרשת השבוע צו
שמיני	פרשת שמיני	פרשת השבוע שמיני
תזריע	פרשת תזריע	פרשת השבוע תזריע
מצורע	פרשת מצורע	פרשת השבוע מצורע
אחרי מות	פרשת אחרי מות	פרשת השבוע אחרי מות
קדושים	פרשת קדושים	פרשת השבוע קדושים
אמור	פרשת אמור	פרשת השבוע אמור
בהר	פרשת בהר	פרשת השבוע בהר
בחוקותי	פרשת בחוקותי	פרשת השבוע בחוקותי
במדבר	ספר במדבר	פרשת במדבר	פרשת השבוע במדבר
נשא	פרשת נשא	פרשת השבוע נשא
בהעלותך	פרשת בהעלותך	פרשת השבוע בהעלותך
שלח לך	פרשת שלח לך	פרשת השבוע שלח לך
קרח	פרשת קרח	פרשת השבוע קרח
חקת	פרשת חקת	פרשת השבוע חקת
בלק	פרשת בלק	פרשת השבוע בלק
פינחס	פרשת פינחס	פרשת השבוע פינחס
מטות	פרשת מטות	פרשת השבוע מטות
מסעי	פרשת מסעי	פרשת השבוע מסעי
דברים	ספר דברים	פרשת דברים	פרשת השבוע דברים
ואתחנן	פרשת ואתחנן	פרשת השבוע ואתחנן
עקב	פרשת עקב	פרשת השבוע עקב
ראה	פרשת ראה	פרשת השבוע ראה
שופטים	פרשת שופטים	פרשת השבוע שופטים
כי תצא	פרשת כי תצא	פרשת השבוע כי תצא
כי תבוא	פרשת כי תבוא	פרשת השבוע כי תבוא
ניצבים	פרשת ניצבים	פרשת השבוע ניצבים
וילך	פרשת וילך	פרשת השבוע וילך
האזינו	פרשת האזינו	פרשת השבוע האזינו
וזאת הברכה	פרשת וזאת הברכה	פרשת השבוע וזאת הברכה
נח	פרשת נח	פרשת השבוע נח
לך לך	פרשת לך לך	פרשת השבוע לך לך
וירא	פרשת וירא	פרשת השבוע וירא
חיי שרה	פרשת חיי שרה	פרשת השבוע חיי שרה
תולדות	פרשת תולדות	פרשת השבוע תולדות
ויצא	פרשת ויצא	פרשת השבוע ויצא
וישלח	פרשת וישלח	פרשת השבוע וישלח
וישב	פרשת וישב	פרשת השבוע וישב
מקץ	פרשת מקץ	פרשת השבוע מקץ
ויגש	פרשת ויגש	פרשת השבוע ויגש
ויחי	פרשת ויחי	פרשת השבוע ויחי

# Topics

חינוך אינטגרלי	חכמת המעגל	חכמת החיבור
תפקיד האישה במערכת הרוחנית	תפקיד האישה
יגיעה	מאמץ
המאור המחזיר למוטב	אור התורה	המאור שבה מחזירו למוטב
עשירייה	עשיריה
מלמעלה	דלעילא
מלמטה	דלתתא
התעוררות	התעוררת	אתערואתא
אין עוד מלבדו	אעמ
מרכז הקבוצה	מרכז העשיריה	מרכז העשירייה
עשיריה	עשירייה
מסירות נפש	למסור את נפשו
צמצום ב	צמצום ב'	צב	צ ב
תפילת רבים	תפילה עבור רבים
נחת רוח	להשפיע נחת רוח	להשפיע נר
על כל פשעים תכסה אהבה	על כל הפשעים תכסה אהבה
בעיתו - אחישנה	בעיתה אחישנה	דרך יסורים ודרך תורה
מתוך שלא לשמה באים לשמה	לשמה ולא לשמה
פרצוף רוחני	פרצוף
כלכלה והעסקים	עסקים	מסחר
אורייתא וקבה וישראל חד הוא	ישראל אורייתא וקובה
שבירת אדם הראשון	חטא אדם הראשון	שבירת אדהר	שבירת אדהר	חטא אדהר	שבירת נשמת אדהר
רשבי	רבי שמעון	רבי שמעון בר יוחאי
ד בחינות דאור ישר	ד בחינות דאוי
דעת בעלי בתים הפוכה מדעת תורה	דעת תורה ודעת בעל בתים
דומם צומח חי מדבר	דצחמ	דצחם
גלגלתא עיניים אוזן חוטם פה	גע	אחפ	גע ואחפ
יום האהבה	טו באב
המקובלים הגדולים	מקובלים
צמצום א	צמצום א'	צא	צ א
שבירת הכלים	שבירת עולם הנקודים	עולם הנקודים בגדלות
עולם האצילות	אצילות
חגים ומועדים	חגים
ט באב	תשעה באב	חורבן בית המקדש	חורבן בהמק
סוכות	סוכה
ראש השנה	רשהש
יום כיפור	יוהכ
טו בשבט	חג לאילנות
יום העצמאות	עצמאות מדינת ישראל
יום השואה	יום השואה והגבורה
יום הזיכרון	יום הזכרון לחללי צהל
צום יז בתמוז	יז בתמוז
ימי בין המצרים	בין המצרים
יום השנה להסתלקותו של הארי	הסתלקות הארי	יורצאייט ארי	יורצאיט ארי	הסתלקות האריזל
עולם הנקודים	נקודים
התכללות מלכות בבינה	מלכות עם בינה	מלכות בבינה	מלכות עולה לבינה
עבודה עם ההפרעות	הפרעות
אדם הראשון	אדהר	נשמת אדהר
תפילה	להתפלל
הורות ומשפחה	הורות	משפחה
חיים קהילתיים	חיי קהילה	קהילה
בין קבלה למיסטיקה	מיסטיקה וקבלה	מיסטיקה
תהליך התיקון	תיקון
יום השנה להסתלקותו של הרבש	הסתלקותו של הרבש	הסתלקות הרבש	יורצאייט רבש
יום השנה להסתלקותו של בעל הסולם	הסתלקות בעל הסולם	הסתלקות בעהס
יחס התלמיד לרב	רב תלמיד יחס
עולם הרגש	רגשות	רגש
הפצת חכמת הקבלה	הפצה
ספרי קבלה	ספר קבלה
כנס	קונגרס	כנס עולמי	כנס קבלה	כנס קבלה לעם	כנס קבלה לעם העולמי
אנטישמיות	שנאה ליהודים
מוסיקה קבלית	ניגונים	ניגוני
רשימות	רשימו
מוסיקה	מוזיקה
סדנה סדנא
לאוניד ליאוניד


# Meals
# סעודת מקובלים	סעודה	טיש	יורצאיט	יורצייט	יארצייט	יאהרצייט	יורצאט (unclear)

# Collections
יסודות הקבלה	ייסודות הקבלה	יסודות חכמת הקבלה	ייסודות חכמת הקבלה

# ConventionLocation
סנט פטרסבורג	פיטר
ארצות הברית ארהב
תורכיה  טורקיה

#Added by Yuri at 16.02.20 (not in spreadsheet)
בא	בוא
ישיבת חברים	ישיבת החברים
נגיף	וירוס