# authors

рабаш	барух шалом алеви ашлаг	рав барух ашлаг	рав барух шалом алеви ашлаг	рав барух шалом	барух ашлаг
бааль сулам	рав йегуда ашлаг	рав йегуда лейб алеви ашлаг	йегуда лейб алеви ашлаг	рав ашлаг	йегуда ашлаг	лейб ошляк
рав лайтман	д-р михаэль лайтман	михаэль лайтман	лайтман	михаил семенович лайтман	доктор м. лайтман
ари	рав ицхак лурия	ицхак лурия	ицхака бен шломо ашкенази лурия	аризаль	святой ари	ицхак лурия ашкенази
рамхаль	моше хаим луцатто	луцатто
рав кук	рав авраам ицхак коэн кук	авраам ицхак кук	авраам ицхак коэн кук	рав авраам ицхак кук
бааль шем тов	бешт

# sources

зоар ла ам	зоар	книга зоар
ночь невесты	тиккун лейл шавуот	ночь шавуот
учение десяти сфирот	тэс	талмуд эсер асфирот	талмуд эсер сфирот
берешит	глава берешит	книга берешит	недельная глава берешит	парашат берешит
шмот	книга шмот	глава шмот	недельная глава шмот	парашат шмот
ваэра	глава ваэра	недельная глава ваэра	парашат ваэра
бо	глава бо	недельная глава бо	парашат бо
бешалах	глава бо	недельная глава бешалах	парашат бешалах
итро	глава итро	недельная глава итро	парашат итро
мишпатим	глава мишпатим	недельная глава мишпатим	парашат мишпатим
трума	глава трума	недельная глава трума	парашат трума
тецаве	глава тецаве	недельная глава тецаве	парашат тецаве
ки тиса	глава ки тиса	недельная глава ки тиса	парашат ки тиса
ваякэль	глава ваякэль	недельная глава ваякэль	парашат ваякэль
пкудэй	глава пкудэй	недельная глава пкудэй	парашат пкудэй
ваикра	книга ваикра	глава ваикра	недельная глава ваикра	парашат ваикра
цав	глава цав	недельная глава цав	парашат цав
шмини	глава шмини	недельная глава шмини	парашат шмини
тазриа	глава тазриа	недельная глава тазриа	парашат тазриа
мецора	глава мецора	недельная глава мецора	парашат мецора
ахарей мот	глава ахарей мот	недельная глава ахарей мот	парашат ахарей мот
кдошим	глава кдошим	недельная глава кдошим	парашат кдошим
эмор	глава эмор	недельная глава эмор	парашат эмор
бехар	глава бехар	недельная глава бехар	парашат бехар
бехукотай	глава бехукотай	недельная глава бехукотай	парашат бехукотай
бамидбар	книга бамидбар	глава бамидбар	недельная глава бамидбар	парашат бамидбар
насо	глава насо	недельная глава насо	парашат насо
беалотха	глава беалотха	недельная глава беалотха	парашат беалотха
шлах	глава шлах	недельная глава шлах	парашат шлах
корах	глава корах	недельная глава корах	парашат корах
хукат	глава хукат	недельная глава хукат	парашат хукат
балак	глава балак	недельная глава балак	парашат балак
пинхас	глава пинхас	недельная глава пинхас	парашат пинхас
матот	глава матот	недельная глава матот	парашат матот
масэй	глава масэй	недельная глава масэй	парашат масэй
дварим	книга дварим	глава дварим	недельная глава дварим	парашат дварим
ваэтханан	глава ваэтханан	недельная глава ваэтханан	парашат ваэтханан
экев	глава экев	недельная глава экев	парашат экев
рээ	глава рээ	недельная глава рээ	парашат рээ
шофтим	глава шофтим	недельная глава шофтим	парашат шофтим
ки тецэ	глава ки тецэ	недельная глава ки тецэ	парашат ки тецэ
ки таво	глава ки таво	недельная глава ки таво	парашат ки таво
ницавим	глава ницавим	недельная глава ницавим	парашат ницавим
ваелех	глава ваелех	недельная глава ваелех	парашат ваелех
аазину	глава аазину	недельная глава аазину	парашат аазину
везот абраха	глава везот абраха	недельная глава везот абраха	парашат везот абраха
ноах	глава ноах	недельная глава ноах	парашат ноах
лех леха	глава лех леха	недельная глава лех леха	парашат лех леха
ваера	глава ваера	недельная глава ваера	парашат ваера
хаей сара	глава хаей сара	недельная глава хаей сара	парашат хаей сара
толдот	глава толдот	недельная глава толдот	парашат толдот
ваеце	глава ваеце	недельная глава ваеце	парашат ваеце
ваишлах	глава ваишлах	недельная глава ваишлах	парашат ваишлах
ваешев	глава ваешев	недельная глава ваешев	парашат ваешев
микец	глава микец	недельная глава микец	парашат микец
ваигаш	глава ваигаш	недельная глава ваигаш	парашат ваигаш
ваехи	глава ваехи	недельная глава ваехи	парашат ваехи

# topics

интегральное воспитание	интегральное взаимодействие	интегральное образование
#роль женщины в духовном	роль женщины
усилие
#свет возвращающий к источнику	свет торы	ор макиф	свет
десятка	десятки
снизу вверх
сверху вниз
пробуждение	пробуждаться
#нет никого кроме него
центр группы	центр десятки
десятка	десятки
преданность	верность
второе сокращение	цимцум бэт	ц"б	ц б	цб
#молитва многих	молитва за других
удовольствие
#все прегрешения покроет любовь
#беито - ахишена	в свой срок - ускорение	путь страданий и путь торы	путь страданий и путь радости
#от лолишма приходим к лишма	лишма и лолишма
духовный парцуф	парцуф
#экономика и бизнес	бизнес	торговля	комерция
#тора, творец и исраэль едины	исраэль, тора и творец	тора и творец - одно
разбиение адам аришон	грех адам аришон	разбиение адама	грех адама	разбиение души адам аришон	разбиение души адама	грех первого человека	разбиение адам ришон
рашби	рабби шимон	рабби шимон бар иохай
4 стадии прямого света	четыре стадии прямого света
#мнение обывателей противоположно мнению торы	мнение торы и мнение обывателей
#домем, цомеах, хай, медабер	неживой, растительный, животный, говорящий	неживое, растительное, животное, человек
#гальгальта эйнаим озен хотем пэ	гальгальта эйнаим	гальгальта и ахап	гальгальта эйнаим и ахап	озен хотем пэ
день любви	пятнадцатое ава	15 ава
великие каббалисты	каббалисты
первое сокращение	цимцум алеф	ц"а	ц а	ца
разбиение сосудов	разбиение мира никудим
мир ацилут	ацилут	олам ацилут
особые даты	праздники
9 ава	десятое ава	разрушение храма	национальный день траура	день траура
суккот	сукка
рош ашана	еврейский новый год
йом кипур	день искупления	судный день	день всепрощения
ту бишват	рош ашана лаиланот	новый год деревьев
день независимости	независимость государства израиля
#день памяти катастрофы	день памяти катастрофы и героизма	день памяти жертв холокоста	день катастрофы
#день памяти	день памяти павших в войнах израиля и жертв террора
пост 17 тамуза	17 тамуза
период "меж теснин"	меж теснин
день памяти ари	день памяти святого ари	годовщина смерти ари	годовщина ухода ари	годовщина памяти ари
мир никудим	никудим
#взаимовключение малхут и бины	малхут и бина	малхут в бине	малхут поднимается в бину	взаимовключение
#работа с помехами	помехи
адам аришон	душа адам аришон	первый человек
молитва	молиться
воспитание семья	родительство	семья
#жизнь сообщества	общинная жизнь	община
#между каббалой и мистикой	мистика и каббала	мистика
процесс исправления	исправление
день памяти рабаша	годовщина смерти рабаша	годовщина ухода рабаша	годовщина памяти рабаша
день памяти бааль сулама	годовщина смерти бааль сулама	годовщина ухода бааль сулама	годовщина памяти бааль сулама
#отношение ученика к учителю	учитель и ученик	учитель	ученик
мир чувств	чувства	эмоции
распространение науки каббала	распространение
каббалистические книги	каббалистическая книга
конгресс каббалы	конгрессы	конгресс	съезд
антисимитизм	ненависть евреям
каббалистическая музыка	мелодия	мелодии
решимот	решимо
музыка

# meals
каббалистические трапезы	трапеза	тиш	годовщина смерти	годовщина ухода	годовщина памяти	день памяти

# collections
основы каббалы	основы науки каббала

# locations
соединенные штаты америки	сша
великобритания	британия	соединенное королевство
